GGWWWWWWWGGGGUGGGGGGGGGGGGGGGGGGGGGGGG
GWWGGGGGGGGGGUGGGGGGGGGGGGGGGGGGGGGGGG
GGGGGWWWWGGGGUGGGGGGGGGGGGGGGGGGGGGGGG
GGGWWWWWWWGGGQGPGPGPGPGPGGWWWWGGGGGGGG
GGWWWWWWWWWWGGGGGGGGGGGGGGGGGGGGGGGGGG
GGQGPGWWWWWWWWGGGGGGGGGGGGGGGGGGWWWGGG
GGGWWWWWWWWGGGGGGGGWWWGGGGGGGGGGGGGGGG
GGGGGGWWWGGGGGGGGGGGGGGGGGWWWGGGGGGGGG
GGGGGGGGGGGGGGGGGGGGGGGGGGGWWGWWWWWGGG
GGGGGGWWWGGGGGGGGGGGGGGGGGGWWWWWWWWWWG
GGGGGGGWGWGGGGGGGGGGGGGGGGGGGGGGGGGGGG
GGGGGGGGWWGGGGGGGGGGGGGGGGGGGGGGGGGGGG
GGWWWWWWWGGGGUGPGPGPGPGGGGGGGGGGGGGGGG
GWWGGGGGGGGGGUGGGGGGGGGGGGGGGGGGGGGGGG
GGGGGWWWWGGGGUGGGGGGGGGGGGGGGGGGGGGGGG
GGGWWWWWWWGGGQGPGPGPGPGPGGWWWWGGGGGGGG
GGWWWWWWWWWWGGGGGGGGGGGGGGGGGGGGGGGGGG
GGQGPGWWWWWWWWGGGGGGGGGGGGGGGGGGWWWGGG
GGGWWWWWWWWGGGGGGGGWWWGGGGGGGGGGGGGGGG
GGGGGGWWWGGGGGGGGGGGGGGGGGWWWGGGGGGGGG
GGGGGGGGGGGGGGGGGGGGGGGGGGGWWGWWWWWGGG
GGGGGGWWWGGGGGGGGGGGGGGGGGGWWWWWWWWWWG
GGGGGGGWGWGGGGGGGGGGGGGGGGGGGGGGGGGGGG
GGGGGGGGWWGGGGGGGGGGGGGGGGGGGGGGGGGGGG