11999999911111111199999991111111
19911111111111111199999991111111
11111999911111111199999991111111
11199999911111111199999991111111
11999999911111111199999991111111
11111199911111111199999991111111
11199999911111111199999991111111
11111199911111111199999991111111
11111199911111111199999991111111
11111199911111111199999991111111
11111199911111111199999991111111
11111199911111111199999991111111
11111199911111111199999991111111
11111199911111111199999991111111
11111199911111111199999991111111
11111119991111111199999991111111
19911111111111111199999991111111
11111999911111111199999991111111
11199999911111111199999991111111
11999999911111111199999991111111
11111199911111111199999991111111
11199999911111111199999991111111
11111199911111111199999991111111
11111199911111111199999991111111
11111199911111111199999991111111
11111199911111111199999991111111
11111199911111111199999991111111
11111199911111111199999991111111
11111199911111111199999991111111
11111199911111111199999991111111
11111119991111111199999991111111